+------------------------------------------+
|                                          |
|                                          |
|   +--------------------------------------+
|   +------------------------+             |
|                                  +---+   |
+----------------------------------+   |   |
|                                      |   |
|                                      |   |
+--------------+      +----------------+   |
|                     |                    |
+--------------+      |  +-----------+     |
|                     |              |     |
|                     |              |     |
|                     +--------------+     |
|                                          |
|                                          |
|                                          |
|                                  +--->   |
|                                          |
+------------------------------------------+

